#########
#.#2|.|.#
###-###-#
#.#.#.#.#
###-#-#-#
#.|.|.|3#
#-#####-#
#.#X|.#.#
#-#-#-#-#
#1|.#.#.#
#-#-#-#-#
#.|.|.#.#
#-#-#####
#.|4#.#.#
###-#####
#.|.#.#.#
#########